#######################################
#........................  #xxxxxxxxxx#
#........................  ############
#........................             #
#.....................................#
#.....................................#
#.....................................#
#.....................................#
#.....................................#
#.....................................#
#####      ###########......###########
#.....................................#
#.....................................#
#.....................................#
#.....................................#
#.....................................#
#.....................................#
#.....................................#
#.....................................#
#.....................................#
#.....................................#
#.....................................#
#.....................................#
#.....................................#
#.....................................#
#.....................................#
#################.....#################
#                ......               #
#                ......               #
#                ......               #
#                ......               #
#                ......               #
#                ******               #
#                ******               #
#                ******               #
#                .......#####....######
#.               .......*****....xxxxx#
#................................xxxxx#
#.......................*****....xxxxx#
#######################################
