#######################################
#.....................................#
#.....................................#
#.....................................#
#....................xx...............#
#....................xx...............#
#.....................................#
#.....................................#
#.....................................#
#.....................................#
#####      ###########..**..###########
#...........          ......          #
#.....................................#
#.....................................#
#.....................................#
#.....................................#
#.....................................#
#.....................................#
#.....................................#
#.....................................#
#.....................................#
#.....................................#
#.....................................#
#.....................................#
#.....................................#
#.....................................#
###################...#################
#.....................................#
#.....................................#
#.....................................#
#.....................................#
#.....................................#
#.....................................#
#.........*****.......................#
#.........*****.......................#
#.........*****.......................#
#.......................#####.........#
#.....................................#
#.....................................#
#######################################
