#######################################
#.....................................#
#.....................................#
#..................******.............#
#..................**xx**.............#
#..................**xx**.............#
#..................      .............#
#.....................................#
#.....................................#
#.....................................#
#######################*****###########
#......................*****..........#
#.....................................#
#.....................................#
#.....................................#
#.....................................#
#.....................................#
#.....................................#
#.....................................#
#.....................................#
#.....................................#
#.....................................#
#.....................................#
#.....................................#
#.....................................#
#.....................................#
###################...#################
#.....................................#
#.....................................#
#.....................................#
#.....................................#
#...........######...................#
#...........#xxxx#....................#
#...........#xxxx#...................#
#...........######....................#
#.....................................#
#.......................#####.........#
#.....................................#
#.....................................#
#######################################
